22222222
20000402
20310002
22220222
20000102
20040002
22222222
